Its a false maze
Is an imperfect maze, let's break it!
█████████████████████████████████████████
█     █                 █         █   █ █
█████ █ ███ █ ███████████ ███ ███ █ █ █ █
█  E█   █ █ █ █     █   █   █   █   █   █
█ ███ ███ █ █ █ ███ █ █ ███ ███ █ ███████
█ █   █   █   █   █   █   █   █ █ █     █
█ ███ ███ ███ █ █ ███████ ███ █ ███ █ █ █
█   █     █ █   █ █     █   █ █     █   █
███ █████ █ ███ █ ███ █ ███ █ ███████ █ █
█   █     █   █       █         █ █   █ █
█ ███ █████ █████ █ █ ███ █████ █ █ ███ █
█ █ █ █       █  E E E  █ █ █ █ █ █   █ █
█ █ █ █ █████ ███ █ █ █ █ ███ █ █ ███ ███
█ █   █   █      E E E E E  █   █       █
█ █ ███████ █████ █ █ █ █ ███ █████ █ █ █
█ █       █   █ █ █  E  █ █ █   █     █ █
█ ███████ ███ █ █ ███ ███ █ ███ █ █████ █
█   █          E E   E   E E    █ █     █
███ █████████ █ █ ███ ███ █ █ ███ █ ███ █
█ █       █    E E   E  █ █ █   █ █   █ █
█ ███████ ███ █ █ ███ ███ █████ █ ███ █ █
█       █   █   █   █       █   █   █ █ █
█ ███ █ ███ █████ █ █████ █ █ █████ █ █ █
█ █ █     █ █   █ █     █ █ █ █     █   █
█ █ █ ███ █ █ █ █ █████ █ █ █ █ ███ █ █ █
█ █ █     █ █ █   █   █   █ █   █   █   █
█ █ █████ █ █ █████ █ █████ █ █ █████ ███
█       █ █ █   █   █ █   █ █   █   █   █
█████ █ █ █ ███ █ █████ █ █ █████ █ ███ █
█       █       █       █         █    X█
█████████████████████████████████████████

===A-Maze-ING===
1. Regenerate maze
2. Show/Hide path from entry to exit
3. Rotate Maze colors
4. Exit
Choise (1-4): 